E E E E E E E E E E E E E E E E E E E E E E E E E E E E E E E E
E 0 A A A A A A A A A A A A A A A A A A A A A A A A A A A A A E
E A A A A A A A 5 A A A A E E A A A A A A A A A A A A A A A A E
E E E A E A A E E E A E E E E E A A A A A A A E E A A A A A A E
E A A A A A A A A A A A A A E E E A A A A A A E E A A E A A A E
E A A A A A A A A A 4 A A A E F F F F F F F E E E A E A A A A E
E A E E E E A E A E E E A E E F E E E E E E E E E A E E E A A E
E F E E E E F E F F E F F F F F E A A A A A E E E A A A A A A E
E F E E E E F F F F F F E E F F F A A A 2 A A E E E A A A 3 A E
E F F E E E E E E E E E E E E E E F E F E F F E E E A A E E A E
E F F E E E E A A A E E E E F F F F E F E F F E A A A E E E W E
E F F E E E E A A A A A E E F F F F E F F F E E A A E E E W W E
E F E E E E 1 A A E E F F E F F F F E E F F E E E E E W W W W E
E F E E E E E E E E E E F F F F F F F F F F W W W W W W W W W E
E F F E E E E E F F E E E E E E F F F F F F W W W W W W E E E E
E F F F E E E F F F F F F F F F F F F F F F F F F F F E E E E E
E F F F F F F F F F F F F F F F F F F F F F F F F F E E E E E E
E E E E E E E E E E E E E E E E E E E E E E E E E E E E E E E E